************************************************
*                                              *
*   *****         *****                        *
*   *                 *                        *
*   *   ***********   *                        *
*                      *****                   *
***********             *****                  *
*                  *                           *
*   *****         *****         *****          *
*                                              *
*   *****                *****                 *
*                                              *
************************************************
