**************************************************
*                                              ***
*   *                  *        &              ***
*   *                  *                       ***
*   *   ***********    *                       ***
*                                     &        ***
*   *******             *****                  ***
*                                              ***
*                               *****          ***
*                                              ***
*   *****                *****          &      ***
*                                              ***
**************************************************
